%%%%%%%%%%
%    % P %
%  % %   %
%  %     %
%  %%%%%%%
%        %
%%%%%%%% %
% .    % %
%%%      %
%%%%%%%%%%